:debuglevel
4
:mapsize
20
:map
1,1,1,1,1,1,1,1,1,1,1,1,1,1,1,1,1,1,1,1,
1,1,1,1,1,1,1,1,1,1,1,1,1,1,1,1,1,1,1,1,
1,1,3,3,3,3,3,3,3,3,3,3,3,3,3,3,3,3,1,1,
1,1,4,4,4,4,7,6,5,8,4,4,4,4,4,4,4,4,1,1,
1,1,3,3,3,4,3,3,3,3,3,3,3,3,3,3,3,3,1,1,
1,1,3,4,3,4,3,3,3,3,3,4,4,4,3,3,3,3,1,1,
1,1,3,4,4,4,3,3,3,3,4,4,4,4,4,3,3,3,1,1,
1,1,3,3,3,4,3,3,3,4,4,4,4,4,4,5,3,3,1,1,
1,1,3,4,4,4,4,4,4,4,4,4,4,4,4,4,3,3,1,1,
1,1,3,4,3,4,4,3,3,4,4,4,4,4,4,4,3,3,1,1,
1,1,3,4,3,3,4,3,3,3,4,4,4,4,4,3,3,3,1,1,
1,1,3,4,3,3,4,3,3,3,3,6,4,4,3,3,3,3,1,1,
1,1,3,4,3,3,4,3,3,3,3,3,3,3,3,3,3,3,1,1,
1,1,3,4,4,4,4,4,4,3,3,3,3,3,3,3,3,3,1,1,
1,1,3,3,4,4,4,4,4,3,3,3,3,3,3,3,3,3,1,1,
1,1,3,3,2,4,4,4,4,3,3,3,3,3,3,3,3,3,1,1,
1,1,3,2,2,2,4,4,4,3,3,3,3,3,3,3,3,3,1,1,
1,1,3,3,3,3,3,3,3,3,3,3,3,3,3,3,3,3,1,1,
1,1,1,1,1,1,1,1,1,1,1,1,1,1,1,1,1,1,1,1,
1,1,1,1,1,1,1,1,1,1,1,1,1,1,1,1,1,1,1,1,
:textures
floor/floor1.bmp
wall/wall1.bmp
static/explosion.bmp
static/tree.bmp
static/mist1.tga
static/button1.bmp
:lightsources
255 30 6 4
:animators
100 128 8 128 128
200 64 3 64 64
:elements
TILE_FLOOR 0 0 0 1 1 false 0 -1
TILE_FRONT 0 0 0 1 1 false 1 -1
TILE_SIDE 0 0 0 1 1 false 1 -1
TILE_STATIC 0.5 0 0.5 1.5 0.5 true 4 -1
TILE_STATIC 0 0 0.5 1 1 false 2 0
TILE_STATIC 0.5 0 0 1 2 false 3 -1
TILE_STATIC 1 0.5 0.5 0.28 0.28 false 5 1
TILE_STATIC 0.5 0 1 1 2 false 3 -1
:tiles
TILE_FLOOR 0 
TILE_FLOOR 0 TILE_STATIC 3 TILE_CEILING 1 
TILE_FRONT 1 
TILE_FLOOR 0 TILE_CEILING 1 
TILE_FLOOR 0 TILE_STATIC_NS 4 TILE_CEILING 1 
TILE_FLOOR 0 TILE_STATIC_EW 5 TILE_STATIC 3 
TILE_FLOOR 0 TILE_STATIC_NS 6 TILE_CEILING 1 
TILE_FLOOR 0 TILE_STATIC_EW 7 TILE_STATIC 3 
:end

