:mapsize
20
:map
1,1,1,1,1,1,1,1,1,1,1,1,1,1,1,1,1,1,1,1,
1,1,1,1,5,6,1,1,1,1,1,1,1,1,1,1,1,1,1,1,
3,3,3,3,3,3,3,3,3,3,3,3,3,3,3,1,1,1,1,1,
1,1,1,5,1,1,2,1,2,1,1,1,4,4,3,1,1,1,1,1,
3,3,3,3,3,3,3,3,3,3,3,4,3,3,3,1,1,1,1,1,
1,1,3,3,3,2,1,2,1,1,3,4,3,1,1,1,1,1,1,1,
1,3,3,4,4,2,1,2,1,1,3,5,3,1,1,1,1,1,1,1,
3,3,4,4,4,2,1,2,1,1,3,4,3,1,1,1,1,1,1,1,
3,4,4,4,4,3,3,1,1,1,3,4,3,1,1,1,1,1,1,1,
3,4,4,4,4,2,3,2,1,3,3,4,3,3,1,1,1,1,1,1,
1,3,3,3,4,3,3,3,3,3,4,4,4,3,1,1,1,1,1,1,
1,3,4,4,4,2,4,2,4,5,4,4,4,3,1,1,1,1,1,1,
1,3,3,3,4,3,3,3,3,3,4,4,4,3,1,1,1,1,1,1,
1,1,1,3,4,3,1,1,1,3,3,4,3,3,1,1,1,1,1,1,
1,1,1,3,3,3,1,1,1,1,3,4,3,1,1,1,1,1,1,1,
1,3,3,3,4,3,3,3,3,3,4,4,4,3,1,1,1,1,1,1,
1,3,4,4,4,2,4,2,4,5,4,4,4,3,1,1,1,1,1,1,
1,3,3,3,4,3,3,3,3,3,4,4,4,3,1,1,1,1,1,1,
1,1,1,3,4,3,1,1,1,3,3,4,3,3,1,1,1,1,1,1,
1,1,1,3,3,3,1,1,1,1,3,4,3,1,1,1,1,1,1,1,
:textures
floor/floor1.bmp
wall/wall1.bmp
static/explosion.bmp
static/tree.bmp
static/mist1.tga
:animators
100 128 8 128 128
:elements
TILE_FLOOR 0 0 0 1 1 false 0 -1
TILE_FRONT 0 0 0 1 1 false 1 -1
TILE_SIDE 0 0 0 1 1 false 1 -1
TILE_STATIC 0.5 0 0.5 1.5 0.5 true 4 -1
TILE_STATIC 0 0 0.5 1 1 false 2 0
TILE_STATIC 0.5 0 0 1 1 false 3 -1
:tiles
TILE_FLOOR 0 TILE_STATIC 3 
TILE_FLOOR 0 TILE_STATIC 3 
TILE_FLOOR 0 TILE_SIDE 1 TILE_FRONT 1 
TILE_FLOOR 0 TILE_CEILING 0 
TILE_FLOOR 0 TILE_CEILING 0 TILE_STATIC_NS 4 
TILE_FLOOR 0 TILE_CEILING 0 TILE_STATIC_EW 5 TILE_STATIC 3 
:end

