[20]
1,1,1,1,1,1,1,1,1,1,1,1,1,1,1,1,1,1,1,1,
1,1,1,1,5,6,1,1,1,1,1,1,1,1,1,1,1,1,1,1,
3,3,3,3,3,3,3,3,3,3,3,3,3,3,3,1,1,1,1,1,
1,1,1,5,1,1,2,1,2,1,1,1,4,4,3,1,1,1,1,1,
3,3,3,3,3,3,3,3,3,3,3,4,3,3,3,1,1,1,1,1,
1,1,3,3,3,2,1,2,1,1,3,4,3,1,1,1,1,1,1,1,
1,3,3,4,4,2,1,2,1,1,3,5,3,1,1,1,1,1,1,1,
3,3,4,4,4,2,1,2,1,1,3,4,3,1,1,1,1,1,1,1,
3,4,4,4,4,3,3,1,1,1,3,4,3,1,1,1,1,1,1,1,
3,4,4,4,4,2,3,2,1,3,3,4,3,3,1,1,1,1,1,1,
1,3,3,3,4,3,3,3,3,3,4,4,4,3,1,1,1,1,1,1,
1,3,4,4,4,2,4,2,4,5,4,4,4,3,1,1,1,1,1,1,
1,3,3,3,4,3,3,3,3,3,4,4,4,3,1,1,1,1,1,1,
1,1,1,3,4,3,1,1,1,3,3,4,3,3,1,1,1,1,1,1,
1,1,1,3,3,3,1,1,1,1,3,4,3,1,1,1,1,1,1,1,
1,3,3,3,4,3,3,3,3,3,4,4,4,3,1,1,1,1,1,1,
1,3,4,4,4,2,4,2,4,5,4,4,4,3,1,1,1,1,1,1,
1,3,3,3,4,3,3,3,3,3,4,4,4,3,1,1,1,1,1,1,
1,1,1,3,4,3,1,1,1,3,3,4,3,3,1,1,1,1,1,1,
1,1,1,3,3,3,1,1,1,1,3,4,3,1,1,1,1,1,1,1,