# .map file for dng0b
# lines starting with # are skipped as comments
# lines starting with : are beginnings of a new block, no leading white-spaces are allowed

:mapsize
20
:map
 2, 2, 2, 2,18,20,17,18,21,19, 2,18,20,17,18,21,19, 2, 2, 2,
 2, 2,17,18,20,17,18,21,19,16,20,17, 2, 2, 2, 2, 2, 2, 2, 2,
 2, 2,18,21,22, 6, 1, 1, 1, 1, 7,17,18,21,19,16,20,17, 2, 2,
 8,17,19,12, 1,11, 2,19,20,21, 5, 1, 1, 1, 1, 1, 1, 1, 1, 1,
 5, 2, 2, 2,21, 1,16,18,22,16,17,18,19,21,20,18,17,16, 2, 2,
16, 2,21, 2,19, 1,21,20,19,17,16, 2, 2, 2,17,22,16,17, 2, 2,
 9, 2,17,18,20, 1,22,17,18,20, 2, 2, 2, 2, 2,19,17,18, 2, 2,
 8, 2,19,21,16,15,21,16,17, 2, 2, 2, 2, 2, 2, 2,20,19, 2, 2,
 6, 2, 2, 2, 2, 2, 2, 2, 2, 2, 2, 2, 2, 2, 2, 2,17,21, 2, 2,
16,19,21, 2,17, 2, 2,20,17, 2, 2, 2, 2, 2, 2, 2,18,20, 2, 2,
 2, 2,18, 2,22,19, 2,22,19,16, 2, 2, 2, 2, 2,19,16,17, 2, 2,
 2, 2,17, 2,20,18, 2,21,18,21,19, 2, 2, 2,17,18,17,22, 2, 2,
 2, 2,16, 2,21,16, 2,17,20,16,22,17,20,17,21,17,18,16, 2, 2,
 2, 2,17, 2, 2, 2, 2, 2, 2,19,18,19,17,17,16,19,17,21, 2, 2,
 2, 2,22,20, 2, 2, 2, 2, 2,18,21,17,17,17,22,17,17,20, 2, 2,
 2, 2,19,21, 2, 2, 2, 2, 2,16,17,18,20,21,17,16,18,19, 2, 2,
 2, 2,18, 2, 2, 2, 2, 2, 2,20,18,21,19,17,18,21,17,18, 2, 2,
 2, 2,17,16,20,19,17,21,16,19,17,20,18,21,20,16,22,20, 2, 2,
 2, 2, 2, 2, 2, 2, 2, 2, 2, 2, 2, 2, 2, 2, 2, 2, 2, 2, 2, 2,
 2, 2, 2, 2, 2, 2, 2, 2, 2, 2, 2, 2, 2, 2, 2, 2, 2, 2, 2, 2,

# TEXTURES
# textures are loaded from /data/images/DIR/NAME.EXE files
# first NAME_close.EXT file is read, then NAME_middle.EXT and NAME_far.EXT files are loaded
# if _middle, or _far files are missing, they are replaced by resizing _close file

:textures

floor/floor1.bmp
wall/wall1.bmp
wall/wall2.bmp
static/mist1.tga
static/button1.bmp
static/doorframe.bmp
static/door.bmp
static/doorside.bmp

# LIGHTSOURCES
# power, decrease per tile, X, Z

:lightsources

# ELEMENTS
# elements are parts of a tile: floor, wall, button texture etc..

:elements
TILE_FLOOR 0 0 0 1 1 false 0 -1 clip
TILE_FRONT 0 0 0 1 0.67 false 2 -1 clip
TILE_FLAT 0 -0.33 0 1 1 false 1 -1 clip

# TILES
# tiles make up the map, a tile has many elements (floor, walls ..etc)

:tiles
TILE_FLOOR 0 TILE_CEILING 2
TILE_FLOOR 0
TILE_SIDE 1 TILE_FRONT 1
TILE_FLOOR 0 TILE_CEILING 2


# TRIGGERS
# triggers handle interaction with the map evironment

:triggers
TRIGGER_ENTER 19 3 2 3 0 0 -1 change_area/area1.area/map1.map
:end

