# .map file for dng0b
# lines starting with # are skipped as comments
# lines starting with : are beginnings of a new block, no leading white-spaces are allowed

:mapsize
20
:map
 2, 2, 2, 2,18,20,17,18,21,19, 2,18,20,17,18,21,19, 2, 2, 2,
 2, 2,17,18,20,17,18,21,19,16,20,17, 2, 2, 2, 2, 2, 2, 2, 2,
 2, 2,18,21,22, 6, 1, 1, 1, 1, 7,17,18,21,19,16,20,17, 2, 2,
 8,17,19,12, 1, 9, 2,19,20,21, 5, 1, 1, 1, 1, 1, 1, 1, 1, 1,
 5, 2, 2, 2,21, 3,16,18,22,16,17,18,19,21,20,18,17,16, 2, 2,
16, 2,21, 2,19, 3,21,20,19,17,16, 2, 2, 2,17,22,16,17, 2, 2,
 9, 2,17,18,20, 3,22,17,18,20, 2, 2, 2, 2, 2,19,17,18, 2, 2,
 8, 2,19,21,16,14,21,16,17, 2, 2, 2, 2, 2, 2, 2,20,19, 2, 2,
 6, 2, 2, 2, 2, 2, 2, 2, 2, 2, 2, 2, 2, 2, 2, 2,17,21, 2, 2,
16,19,21, 2,17, 2, 2,20,17, 2, 2, 2, 2, 2, 2, 2,18,20, 2, 2,
 2, 2,18, 2,22,19, 2,22,19,16, 2, 2, 2, 2, 2,19,16,17, 2, 2,
 2, 2,17, 2,20,18, 2,21,18,21,19, 2, 2, 2,17,18,17,22, 2, 2,
 2, 2,16, 2,21,16, 2,17,20,16,22,17,20,17,21,17,18,16, 2, 2,
 2, 2,17, 2, 2, 2, 2, 2, 2,19,18,19,17,17,16,19,17,21, 2, 2,
 2, 2,22,20, 2, 2, 2, 2, 2,18,21,17,17,17,22,17,17,20, 2, 2,
 2, 2,19,21, 2, 2, 2, 2, 2,16,17,18,20,21,17,16,18,19, 2, 2,
 2, 2,18, 2, 2, 2, 2, 2, 2,20,18,21,19,17,18,21,17,18, 2,23,
 2, 2,17,16,20,19,17,21,16,19,17,20,18,21,20,16,22,20, 2,22,
 2, 2, 2, 2, 2, 2, 2, 2, 2, 2, 2, 2, 2, 2, 2, 2, 2, 2, 2,21,
 1, 2, 3, 4, 5, 6, 7, 8, 9,10,11,12,13,14,15,16,17,18,19,20,

# TEXTURES
# textures are loaded from /data/images/DIR/NAME.EXE files
# first NAME_close.EXT file is read, then NAME_middle.EXT and NAME_far.EXT files are loaded
# if _middle, or _far files are missing, they are replaced by resizing _close file

# LIGHTSOURCES
# power, decrease per tile, X, Z

:lightsources


# TRIGGERS
# triggers handle interaction with the map evironment

:triggers
TRIGGER_ENTER 19 3 2 3 0 0 -1 change_area/area1.area/map1.map
:end

