# .map file for dng0b
# lines starting with # are skipped as comments
# lines starting with : are beginnings of a new block, no leading white-spaces are allowed

:mapsize
20
:map
 1, 1, 1, 1, 1, 1, 1, 1, 1, 1, 1, 1, 1, 1, 1, 1, 1, 1, 1, 1,
 1, 1, 3, 3, 3, 1, 1, 1, 1, 1, 1, 1, 1, 1, 1, 1, 1, 1, 1, 1,
16,13, 3,11, 3, 3, 3, 3, 3, 3, 3, 3, 3, 3, 3, 3, 3, 3, 3, 1,
17,12, 4, 4, 6, 9, 7, 4, 4, 4, 6, 4, 4, 4, 4, 6, 4, 4, 3, 1,
15,14, 3, 3, 3, 4, 3, 3, 3, 3, 3, 4, 3, 3, 3, 3, 3, 3, 3, 1,
 1, 1, 3, 4, 3,10, 3, 3, 3, 3, 3, 4, 4, 4, 3, 3, 3, 3, 1, 1,
 1, 1, 3, 4, 4, 4, 3, 3, 3, 3, 4, 4, 4, 4, 4, 3, 3, 3, 1, 1,
 1, 1, 1, 3, 3, 4, 3, 3, 3, 4, 4, 4, 4, 4, 4, 5, 3, 3, 1, 1,
 1, 1, 3, 4, 4, 4, 4, 4, 4, 4, 4, 4, 4, 4, 4, 4, 3, 3, 1, 1,
 1, 1, 3, 4, 3, 4, 4, 3, 3, 4, 4, 4, 4, 4, 4, 4, 3, 3, 1, 1,
 1, 1, 3, 4, 3, 3, 4, 3, 3, 3, 4, 4, 4, 4, 4, 3, 3, 3, 1, 1,
 1, 1, 3, 4, 3, 3, 4, 3, 3, 3, 3, 6, 4, 4, 3, 3, 3, 3, 1, 1,
 1, 1, 3, 4, 3, 3, 4, 3, 3, 3, 3, 3, 3, 3, 3, 3, 3, 3, 1, 1,
 1, 1, 3, 4, 4, 4, 4, 4, 4, 3,12,14,17,17, 3, 3, 3, 3, 1, 1,
 1, 1, 3, 3, 4, 4, 4, 4, 4, 3,14,16,13, 1, 3, 3, 3, 3, 1, 1,
 1, 1, 3, 3, 2, 4, 4, 4, 4, 3,12,13,15,13, 3, 3, 3, 3, 1, 1,
 1, 1, 3, 2, 2, 2, 4, 4, 4, 3,13,14,12,14, 3, 3, 3, 3, 1, 1,
 1, 1, 3, 3, 3, 3, 3, 3, 3, 3,17,13,12, 1, 3, 3, 3, 3, 1, 1,
 1, 1, 1, 1, 1, 1, 1, 1, 1, 1, 1, 1, 1, 1, 1, 1, 1, 1, 1, 1,
 1, 1, 1, 1, 1, 1, 1, 1, 1, 1, 1, 1, 1, 1, 1, 1, 1, 1, 1, 1,

# LIGHTSOURCES
# power, decrease per tile, X, Z

:lightsources
255 255 4.5 3.0
255 255 10.5 3.0
255 255 15.5 3.0
255 120 1 3.5

# TRIGGERS
# triggers handle interaction with the map evironment

:triggers
TRIGGER_ENTER 3 3 150 150 200 200 -1 none
TRIGGER_EAST 5 3 50 50 100 100 0 none
TRIGGER_SOUTH 6 3 295 118 345 153 2 none
TRIGGER_SOUTH 5 4 421 129 471 164 3 none
TRIGGER_NORTH 5 6 170 137 210 164 3 none
TRIGGER_SOUTH 6 3 295 118 345 153 1 none
TRIGGER_SOUTH 5 4 421 129 471 164 1 none
TRIGGER_NORTH 5 6 170 137 210 164 1 none
BLOCKER_SOUTH 5 3 65 0 0 0 2 none
#BLOCKER_NORTH 5 4 65 0 0 0 2 none
BLOCKER_ENTER 5 5 65 0 0 0 3 none
#BLOCKER_NORTH 5 6 65 0 0 0 3 none
TRIGGER_ENTER 3 2 3 5 0 0 -1 change_map/map2.map
TRIGGER_ENTER 2 3 19 3 0 0 -1 change_area/area2.area/map-2-1.map
:end

