# .map file for dng0b
# lines starting with # are skipped as comments
# lines starting with : are beginnings of a new block, no leading white-spaces are allowed

:mapsize
20
:map
1, 1, 1, 1, 1, 1, 1, 1, 1, 1, 1, 1, 1, 1, 1, 1, 1, 1, 1, 1,
1, 1, 1, 1, 3, 3, 3, 3, 3, 3, 3, 3, 1, 1, 1, 1, 1, 1, 1, 1,
1, 1, 3, 3, 3, 4, 4, 4, 4, 4, 4, 3, 3, 3, 3, 3, 3, 3, 3, 1,
3, 3, 3, 4, 4, 4, 4, 4, 4, 4, 4, 4, 4, 4, 4, 4, 4, 6, 3, 1,
3, 4, 4, 4, 3, 4, 3, 3, 4, 4, 3, 3, 4, 4, 3, 3, 3, 3, 3, 1,
3,10, 3,18, 3, 4, 3, 3, 4, 3, 3, 6, 4, 3, 3, 3, 3, 3, 1, 1,
3, 4, 3, 3, 3, 4, 3, 3, 3, 3, 3, 4, 4, 3, 4, 3, 3, 3, 1, 1,
3, 4, 3, 3, 3, 4, 3, 3, 3, 4, 3, 3, 3, 3, 4, 4, 3, 3, 1, 1,
3, 4, 4, 4, 4, 4, 4, 4, 4, 4, 4, 4, 4, 3, 3, 4, 3, 3, 1, 1,
3, 3, 3, 4, 3, 4, 4, 3, 4, 3, 4, 3, 3, 3, 4, 4, 3, 3, 1, 1,
1, 1, 3, 4, 3, 3, 4, 3, 4, 3, 4, 3, 4, 4, 4, 3, 3, 3, 1, 1,
1, 1, 3, 4, 3, 3, 4, 3, 3, 3, 4, 4, 4, 4, 3, 3, 3, 3, 1, 1,
1, 1, 3, 4, 3, 3, 4, 3, 3, 3, 3, 3, 3, 4, 4, 4, 4, 3, 1, 1,
1, 1, 3, 4, 4, 4, 4, 4, 6, 3, 3, 3, 3, 4, 4, 3, 4, 3, 1, 1,
1, 1, 3, 3, 4, 4, 4, 4, 4, 4, 4, 4, 4, 4, 4, 4, 4, 6, 3, 1,
1, 1, 3, 3, 2, 4, 4, 4, 4, 3, 3, 3, 3, 4, 3, 3, 4, 3, 3, 1,
1, 1, 3, 2, 2, 2, 4, 4, 4, 3, 3, 4, 6, 4, 3, 3, 3, 3, 3, 1,
1, 1, 3, 3, 3, 3, 3, 3, 3, 3, 3, 3, 3, 3, 3, 3, 3, 3, 3, 1,
1, 1, 1, 1, 1, 1, 1, 1, 1, 1, 1, 1, 1, 1, 1, 1, 1, 1, 1, 1,
1, 1, 1, 1, 1, 1, 1, 1, 1, 1, 1, 1, 1, 1, 1, 1, 1, 1, 1, 1,

# LIGHTSOURCES
# power, decrease per tile, X, Z

:lightsources
255 255 8.5 13.0
255 255 12.5 16.0
255 255 17.5 14.0
255 355 11.5 5.0
255 255 17.5 3.0

# TRIGGERS
# triggers handle interaction with the map evironment

:triggers
TRIGGER_ENTER 3 5 3 2 0 0 -1 change_map/map1.map
TRIGGER_SOUTH 1 4 421 129 471 164 3 none
TRIGGER_NORTH 1 6 170 137 210 164 3 none
BLOCKER_ENTER 1 5 65 0 0 0 3 none
:end

